14
XXXXXXXXXXXXXXX
X.............X
X.XXX.XXXXXXX.X
X.X.........X.X
X.X.XXX.XXX.X.X
X.......X.....X
X.XXX.XXX...X.X
X.X.........X.X
X.X...XXX.XXX.X
X.............X
X.XXX.X.X.XXX.X
X.X...X.X.....X
X.X.X.X.XXX.X.X
X...X.........X
XXXXXXXXXXXXXXX
