14
XXXXXXXXXXXXXXX
X.....X.X.....X
X..XXXX.XXXX..X
X.X.........X.X
X.X.........X.X
X.X.........X.X
XXX....X....XXX
X.....X.X.....X
XXX....X....XXX
X.X.........X.X
X.X.........X.X
X.X.........X.X
X..XXXX.XXXX..X
X.....X.X.....X
XXXXXXXXXXXXXXX
