14
XXXXXXXXXXXXXXX
X.............X
X.X...X.X...X.X
X.X...X.X...X.X
X.X...X.X...X.X
X.....X.X.....X
X...XXX.XXX...X
X...X.....X...X
X.XXXXX.XXXXX.X
X.............X
X.XXXXX.XXXXX.X
X...X.....X...X
X...XXX.XXX...X
X.............X
XXXXXXXXXXXXXXX
