20
XXXXXXXXXXXXXXXXXXXXX
X...................X
X..XX...........XX..X
X.X.X...........X.X.X
X.XXXXXXXXXXXXXXXXX.X
X...X.X...X.....X...X
X...X.X.XXXXX.X.X...X
X...X...X.....X.X...X
X...X.XXX.XXXXX.X...X
X...X...........X...X
X...X.XXX.X.XXX.X...X
X...X.....X.....X...X
X...X.XXXXXXXXX.X...X
X...X.X.......X.X...X
X...X.X.X...X.X.X...X
X...X...X...X...X...X
X.XXXXXXX...XXXXXXX.X
X.X.X...........X.X.X
X..XX...........XX..X
X...................X
XXXXXXXXXXXXXXXXXXXXX

