20
XXXXXXXXXXXXXXXXXXXXX
X...................X
X.XXX.XXX.XXX.X.XXX.X
X.X.........X.X...X.X
X.XXXXX.XXXXX.XXX.X.X
X.X...X.........X...X
X.X.X.XXX.X.XXX.X.X.X
X...X.....X...X.X.X.X
X.X.XXX.XXX.XXX.X.X.X
X.X...X.X...X.......X
X.XXX.XXX.XXX.X.XXX.X
X...X.....X...X...X.X
X.X.XXX...XXX.X.X.X.X
X.X...X.....X...X...X
X.X.XXX.XXX.XXX.XXX.X
X...X...X.X...X.X...X
X.XXX.XXX.XXX.X.X.X.X
X.X...X.....X...X.X.X
X.X.XXX.XXX.XXX.XXX.X
X...................X
XXXXXXXXXXXXXXXXXXXXX

