20
XXXXXXXXXXXXXXXXXXXXX
X.....X.......X.....X
X.XXX.X.XXXXX.X.XXX.X
X.X.......X.......X.X
X.X...X...X...X...X.X
X.....X.......X.....X
XXX.XXXXX...XXXXX.XXX
X.....X.......X.....X
X.X...X...X...X...X.X
X.X.......X.......X.X
X.XXX...XXXXX...XXX.X
X.X.......X.......X.X
X.X...X...X...X...X.X
X.....X.......X.....X
XXX.XXXXX...XXXXX.XXX
X.....X.......X.....X
X.X...X...X...X...X.X
X.X.......X.......X.X
X.XXX.X.XXXXX.X.XXX.X
X.....X.......X.....X
XXXXXXXXXXXXXXXXXXXXX
