18
XXXXXXXXXXXXXXXXXXX
X.................X
X.XXXXXXXXX.XXXXX.X
X.X.............X.X
X.X.XXXXXXXXX.X.X.X
X.X...X.....X.X.X.X
X.XXX.X.XXX.X.X.X.X
X...X...X...X.X.X.X
X.XXXXXXX.X.X.X.X.X
X.......X.X.X...X.X
X.XXX.XXX.X.X.XXX.X
X.X.X.......X...X.X
X.XXX.XXXXXXX.X.X.X
X.X.....X.....X...X
X.XXX.XXX.XXX.X.X.X
X.X.X.....X.....X.X
X.X.XXXXXXXXXXXXX.X
X.................X
XXXXXXXXXXXXXXXXXXX
