20
XXXXXXXXXXXXXXXXXXXXX
X...................X
X...X.XXX...XXX.X...X
X...X...X...X...X...X
X.XX..X.X.X.X.X..XX.X
X.....X...X...X.....X
X.X.XX..X.X.X..XX.X.X
X.X.....X...X.....X.X
X.XXX.XX..X..XX.XXX.X
X.........X.........X
X...XXX.XX.XX.XXX...X
X.........X.........X
X.XXX.XX..X..XX.XXX.X
X.X.....X...X.....X.X
X.X.XX..X.X.X..XX.X.X
X.....X...X...X.....X
X.XX..X.X.X.X.X..XX.X
X...X...X...X...X...X
X...X.XXX...XXX.X...X
X...................X
XXXXXXXXXXXXXXXXXXXXX

