18
XXXXXXXXXXXXXXXXXXX
X.................X
X.XXXXX.XXX.XXXXX.X
X.X.X.X.X.X.X.X.X.X
X.XXXXX.XXX.XXXXX.X
X.X.X...X.X...X.X.X
X.XXX.XXXXXXX.XXX.X
X.....X.X.X.X.....X
X.XXXXXXXXXXXXXXX.X
X.X.X.X.X.X.X.X.X.X
X.XXXXXXXXXXXXXXX.X
X.....X.X.X.X.....X
X.XXX.XXXXXXX.XXX.X
X.X.X...X.X...X.X.X
X.XXXXX.XXX.XXXXX.X
X.X.X.X.X.X.X.X.X.X
X.XXXXX.XXX.XXXXX.X
X.................X
XXXXXXXXXXXXXXXXXXX
