34
XXXXXXXXXXXXXXXXXXXXXXXXXXXXXXXXXXX
X.................................X
X.XXX.XXX.XXX.XXX.XXX.XXX.XXX.XXX.X
X.X.X.X.X.X.X.X.X.X.X.X.X.X.X.X.X.X
X.XXX.XXX.XXX.XXX.XXX.XXX.XXX.XXX.X
X.................................X
X.XXX.XXX.XXX.XXX.XXX.XXX.XXX.XXX.X
X.X.X.X.X.X.X.X.X.X.X.X.X.X.X.X.X.X
X.XXX.XXX.XXX.XXX.XXX.XXX.XXX.XXX.X
X.................................X
X.XXX.XXX.XXX.XXX.XXX.XXX.XXX.XXX.X
X.X.X.X.X.X.X.X.X.X.X.X.X.X.X.X.X.X
X.XXX.XXX.XXX.XXX.X.X.XXX.XXX.XXX.X
X.................................X
X.XXX.XXX.XXX.XXX.XXX.XXX.XXX.XXX.X
X.X.X.X.X.X.X.X.X.X.X.X.X.X.X.X.X.X
X.XXX.XXX.XXX.XXX.XXX.XXX.XXX.XXX.X
X.................................X
X.XXX.XXX.XXX.XXX.XXX.XXX.XXX.XXX.X
X.X.X.X.X.X.X.X.X.X.X.X.X.X.X.X.X.X
X.XXX.XXX.XXX.XXX.XXX.XXX.XXX.XXX.X
X.................................X
X.XXX.XXX.X.X.XXX.XXX.XXX.XXX.XXX.X
X.X.X.X.X.X.X.X.X.X.X.X.X.X.X.X.X.X
X.XXX.XXX.XXX.XXX.XXX.XXX.XXX.XXX.X
X.................................X
X.XXX.XXX.XXX.XXX.XXX.XXX.XXX.XXX.X
X.X.X.X.X.X.X.X.X.X.X.X.X.X.X.X.X.X
X.XXX.XXX.XXX.XXX.XXX.XXX.XXX.XXX.X
X.................................X
X.XXX.XXX.XXX.XXX.XXX.XXX.XXX.XXX.X
X.X.X.X.X.X.X.X.X.X.X.X.X.X.X.X.X.X
X.XXX.XXX.XXX.XXX.XXX.XXX.XXX.XXX.X
X.................................X
XXXXXXXXXXXXXXXXXXXXXXXXXXXXXXXXXXX
