18
XXXXXXXXXXXXXXXXXXX
X.................X
X.................X
X.................X
X.................X
X.................X
XXXXXXXXX.XXXXXXXXX
X.......X.X.......X
X.XXX.X.X.X.X.XXX.X
X.X.X.X.....X.X...X
X.XXX.X.XXX.X.X.XXX
X.....X.....X.....X
X.XXX.XXX.XXX.XXX.X
X.X...........X.X.X
X.X.X.XXX.X.X.X.X.X
X.X.X.X...X.X...X.X
X.X.X.X.XXX.XXX.X.X
X...X.............X
XXXXXXXXXXXXXXXXXXX
