16
XXXXXXXXXXXXXXXXX
X.......X.......X
X..XXXX.X.XXXX..X
X.X.....X.....X.X
X.X.XXXXXXXXX.X.X
X.X...........X.X
X.XXXXXXXXXXXXX.X
X.............X.X
X..XXXX...XXXX..X
X.X.............X
X.XXXXXXXXXXXXX.X
X.X...........X.X
X.X.XXXXXXXXX.X.X
X.X.....X.....X.X
X..XXXX.X.XXXX..X
X.......X.......X
XXXXXXXXXXXXXXXXX

