14
XXXXXXXXXXXXXXX
X.............X
XXX.XXXXXXX.XXX
X...X.....X...X
X.X.X.X.X.X.X.X
X.X.X.X.X.X.X.X
X.XXXXX.XXXXX.X
X.............X
X.XXXXX.XXXXX.X
X.X.X.X.X.X.X.X
X.X.X.X.X.X.X.X
X...X.....X...X
XXX.XXXXXXX.XXX
X.............X
XXXXXXXXXXXXXXX
