20
XXXXXXXXXXXXXXXXXXXXX
X...................X
X.......XXX.XXXXX...X
X.......X.X.X.X.....X
X.XXXXX.X.XXX.X..XX.X
X.X...X.X.....X.X.X.X
X.XX..XXXXX.XX..X.X.X
X...X.......X...X.X.X
X...X.XXXXX.X.XXX.X.X
X...X.X...X.X.X...X.X
X...XXX...X.XXX.XXX.X
X.........X.....X...X
X...XXXXX.X.XXX.XXX.X
X...X...X.X.X.....X.X
X...XX..XXX.X.XXXXX.X
X.....X.......X.....X
X...XXX.XXXXX.XXX...X
X...X...X...X...X...X
X...XXXXX...XXXXX...X
X...................X
XXXXXXXXXXXXXXXXXXXXX

