18
XXXXXXXXXXXXXXXXXXX
X.X.X.X.....X.X.X.X
XXX.XXX.XXX.XXX.XXX
X.......X.X.......X
XXX.XXX.XXX.XXX.XXX
X.X.X.X.....X.X.X.X
XXX.XXXXX.XXXXX.XXX
X.....X.X.X.X.....X
X.XXX.XXX.XXX.XXX.X
X.X.X.........X.X.X
X.XXX.XXX.XXX.XXX.X
X.....X.X.X.X.....X
XXX.XXXXX.XXXXX.XXX
X.X.X.X.....X.X.X.X
XXX.XXX.XXX.XXX.XXX
X.......X.X.......X
XXX.XXX.XXX.XXX.XXX
X.X.X.X.....X.X.X.X
XXXXXXXXXXXXXXXXXXX
