20
XXXXXXXXXXXXXXXXXXXXX
X...X...........X...X
X.XXX.XXXXXXXXX.X.X.X
X.X.....X.....X.X.X.X
X.X.X.X.X.XXX.X.X.X.X
X.X.X.X.X.X.X.X.X.X.X
X.X.X.X.X.X.X.X.X.X.X
X.X.X.X.X.X.X.X.X.X.X
X.X.X.X.X.X.X.X.X.X.X
X...................X
X...................X
X...................X
X.X.X.X.X.X.X.X.X.X.X
X.X.X.X.X.X.X.X.X.X.X
X.X.X.X.X.X.X.X.X.X.X
X.X.X.X.X.X.X.X.X.X.X
X.X.X.X.X.X.XXX.X.X.X
X.X.X.X...X...X.X.X.X
X.X.X.XXXXXXXXX.X.X.X
X...................X
XXXXXXXXXXXXXXXXXXXXX
