20
XXXXXXXXXXXXXXXXXXXXX
X.......X...........X
X.XXX.X.X.XXX.XXXXX.X
X.X...X...........X.X
X.X...XXX.XXXXX...X.X
X.X.....X.....X...X.X
X.XXX.XXXXX...XXX.X.X
X.........X...X.....X
X.X.XXX...X.XXX.XXX.X
X.X...X...X.......X.X
XXX.XXX.X.X.XXX.XXX.X
X.X.X...X.....X.....X
X.X.XXX.X.X.X.XXXXX.X
X.....X...X.X.......X
X.XXXXX...X.XXX...X.X
X.X.......X.......X.X
X.X.XXX.XXX.XXXXX.X.X
X.X...............X.X
X.XXXXX...XXX.XXXXX.X
X.........X.........X
XXXXXXXXXXXXXXXXXXXXX
