20
XXXXXXXXXXXXXXXXXXXXX
X...................X
X...XXX.XXX.XXX.XXX.X
X...X.X.X.X.X.X.X.X.X
X.XXX.XXX.X.X.XXX.X.X
X.X.......X.X.....X.X
X.X.XXXXX.X.X.X.XXX.X
X.X...........X.X...X
X.XXXXX...X...X.XXX.X
X.........X.......X.X
X.XXXXX.XXXXX.XXXXX.X
X.X.......X.........X
X.XXX.X...X...XXXXX.X
X...X.X...........X.X
X.XXX.X.X.X.XXX.XXX.X
X.X.....X.X.....X...X
X.X.XXX.X.X.XXX.XXX.X
X.X.X.X.X.X.X.X...X.X
X.XXX.XXX.XXX.XXXXX.X
X...................X
XXXXXXXXXXXXXXXXXXXXX
