14
XXXXXXXXXXXXXXX
X...X.....X...X
X..XX.....XX..X
X.X.X.....X.X.X
XXXX.......XXXX
X.............X
X......X......X
X.....X.X.....X
X......X......X
X.............X
XXXX.......XXXX
X.X.X.....X.X.X
X..XX.....XX..X
X...X.....X...X
XXXXXXXXXXXXXXX
