20
XXXXXXXXXXXXXXXXXXXXX
X.X.X.X.......X.X.X.X
XXXXXXX.X.XXX.XXXXXXX
X.X.....X...X.....X.X
XXX...X.XXX.X.X...XXX
X.X...X.X...X.X...X.X
XXX.XXX.X.XXX.XXX.XXX
X.......X...X.......X
X.XXXXXXX...XXXXXXX.X
X.X...X.........X...X
X.X.X.X.......X.X.X.X
X...X.........X...X.X
X.XXXXXXX...XXXXXXX.X
X.......X...X.......X
XXX.XXX.XXX.X.XXX.XXX
X.X...X.X...X.X...X.X
XXX...X.X.XXX.X...XXX
X.X.....X...X.....X.X
XXXXXXX.XXX.X.XXXXXXX
X.X.X.X.......X.X.X.X
XXXXXXXXXXXXXXXXXXXXX

