14
XXXXXXXXXXXXXXX
X.............X
X.XXX.XXX.XXX.X
X.X.X.X.X.X.X.X
X.XXX.XXX.XXX.X
X.............X
X.XXX.XXX.XXX.X
X.X.X.X.X.X.X.X
X.XXX.XXX.XXX.X
X.............X
X.XXX.XXX.XXX.X
X.X.X.X.X.X.X.X
X.XXX.XXX.XXX.X
X.............X
XXXXXXXXXXXXXXX
