14
XXXXXXXXXXXXXXX
X.......X.....X
X.XXX.X.X.XXX.X
X.X.X.X.X.X.X.X
X.XXX.X.X.XXX.X
X.....X.X.....X
XXXXXXX.XXXXX.X
X.............X
X.XXXXX.XXXXXXX
X.....X.X.....X
X.XXX.X.X.XXX.X
X.X.X.X.X.X.X.X
X.XXX.X.X.XXX.X
X.....X.......X
XXXXXXXXXXXXXXX
