18
XXXXXXXXXXXXXXXXXXX
X.................X
X.XXX.XXXXXXX.XXX.X
X.X.....X.......X.X
X.X.XXXXX.XXX.X.XXX
X.X.......X.X.X.X.X
X.X.XXXXXXXXX.XXX.X
X...X.............X
X.XXX.X.XXX.XXX.X.X
X.X...X...X.X...X.X
X.X.XXXXX.X.X.XXX.X
X.X...X...X.X...X.X
X.XXX.X.XXX.X.X.X.X
X...X...X...X.X...X
X.X.XXX.X.X.XXX.X.X
X.X...X...X.....X.X
X.XXX.X.XXXXX.XXX.X
X.................X
XXXXXXXXXXXXXXXXXXX
