10
XXXXXXXXXXX
X.X.X.X.X.X
XXXXXXXXXXX
X.X.....X.X
XXX.XXX.XXX
X.X.X.X.X.X
XXX.XXX.XXX
X.X.....X.X
XXXXXXXXXXX
X.X.X.X.X.X
XXXXXXXXXXX
