20
XXXXXXXXXXXXXXXXXXXXX
X...................X
X...................X
X...................X
X...XXXXXXXXXXXXX...X
X...X...........X...X
X.XXX.X.XXX.XXX.X...X
X.....X...X.....X...X
X.XXXXX.X.X.XXX.X...X
X...X...X.....X.X...X
X...X.XXX.XXX.X.X...X
X...X...........X...X
X...X.XXX.X.X.XXXXX.X
X...X.X...X.X.X.....X
X...X.X.XXX.X.X.XXX.X
X...X...........X...X
X...XXXXXXXXXXXXX...X
X...................X
X...................X
X...................X
XXXXXXXXXXXXXXXXXXXXX
