24
XXXXXXXXXXXXXXXXXXXXXXXXX
X.X...X...........X.X.X.X
X.XXX.X.XXXXX.XXXXX.XXXXX
X.....X.....X.X.......X.X
XXX.X.X.XXX.XXX.......XXX
X...X...X...............X
X.XXX.X.X.XXX.X.......XXX
X.X...X...X.X.X.......X.X
X.XXXXXXX.X.X.XXXXX.XXX.X
X.......X.X.X...........X
X.XXX.XXXXX.XXX.XXXXXXX.X
X.............X.........X
X.XXX.XXXXXXX.X.XXXXXXX.X
X.X...X.X.....X.......X.X
XXX.X.X.X.....X.XXXXXXX.X
X...X.X.X.....X.X.......X
X.X.X.X.X.XXX.X.X.......X
X.X...X.X.....X.X.......X
XXX.XXX.X.....X.X.......X
X...X...X.......X.......X
X.XXXXX.X.XXX.XXX.......X
X...X.........X.........X
X.X.X...XXXXX.X.XXXXXXXXX
X.X.....................X
XXXXXXXXXXXXXXXXXXXXXXXXX
