20
XXXXXXXXXXXXXXXXXXXXX
X...................X
X.X.XXXXXXXXXXXXXXX.X
X.X.........X.......X
X.X.XXX.X.XXXXXXX.X.X
X.X.X...X.X.....X.X.X
X.X.X.XXX.X.XXX.X.X.X
X.X...X.....X.X.X.X.X
X.X.X.XXXXXXX.X.X.X.X
X.X.X.........X.X.X.X
X.XXX.XXX...XXX.X.X.X
X.X...X...........X.X
X.X.X.XXXXXXX.X.XXX.X
X.X.X.......X.X...X.X
X.X.X.XXXXX.X.XXX.X.X
X.X.X.....X.....X.X.X
X.X.XXXXX.XXX.XXX.X.X
X.............X...X.X
X.XXXXXXXXXXXXX.XXX.X
X...................X
XXXXXXXXXXXXXXXXXXXXX
