32
XXXXXXXXXXXXXXXXXXXXXXXXXXXXXXXXX
X.......X.......X.......X.......X
X.......X.X...X.X.XXX...X...X...X
X.......X.X...X.........X...X...X
X.......X.X...X.X.X.XXX.X...X...X
X.......X.......X.X.....X.......X
X...XXXXX...XXXXXXXXX...XXXXX...X
X...X.........X.X...........X...X
X...XXX...X...X.X.....X...XXX...X
X...X.....X...........X.....X...X
X...X.....XXX...X...XXX.....X...X
X...............X...............X
X.X.X.XXX.X.....X.X.....XXX.XXX.X
X.X.X.....X.....X.X...X.....X.X.X
X.XXX...X.X.XXX.X.X...X.X...X.X.X
X.......X.....X.X.X.....X.......X
XXX...XXX.XXXXXXXXXXXXX.XXX...XXX
X.......X.....X.X.X.....X.......X
X.XXX...X.X...X.X.XXX.X.X...X.X.X
X.X.X.....X...X.X.....X.....X.X.X
X.X.X.XXX.X...X.X.....X.XXX.XXX.X
X...............X...............X
X...X.....XXX...X...XXX.....X...X
X...X.....X...........X.....X...X
X...XXX...X.....X.X...X...XXX...X
X...X...........X.X.........X...X
X...XXXXX...XXXXXXXXX...XXXXX...X
X.......X.....X.X.......X.......X
X...X...X.XXX.X.X.X...X.X.......X
X...X...X.........X...X.X.......X
X...X...X...XXX.X.X...X.X.......X
X.......X.......X.......X.......X
XXXXXXXXXXXXXXXXXXXXXXXXXXXXXXXXX
