20
XXXXXXXXXXXXXXXXXXXXX
X...X...X...X...X...X
XXX.X.X.X.X.X.X.X.X.X
X.....X...X...X...X.X
XXXXX.XXXXXXXXXXXXX.X
X...................X
X.XXXXX.X...XXX.XXX.X
X...X...X...X.X.X.X.X
X...X.XXXXX.XXX.XXX.X
X...X...X...........X
X.XXXXX.X.XXX.XXX.XXX
X.........X.X.X.X.X.X
XXXXX.....XXX.XXX.X.X
X...................X
X.XXXXXX..XXXXXXX...X
X.........X.....X...X
X.XXX.XXX.X.X.X.X.XXX
X.X.X.X.X...X.X.....X
X.XXX.XXX...X.X.X...X
X...........X...X...X
XXXXXXXXXXXXXXXXXXXXX
