14
XXXXXXXXXXXXXXX
X.............X
X.XXXXX.XXXXX.X
X.X.........X.X
X.X...XXX...X.X
X.X.........X.X
X.X.X.XXX.X.X.X
X...X.X.X.X...X
X.X.X.XXX.X.X.X
X.X.........X.X
X.X...XXX...X.X
X.X.........X.X
X.XXXXX.XXXXX.X
X.............X
XXXXXXXXXXXXXXX
