14
XXXXXXXXXXXXXXX
X.............X
X.XXXXXXXXXXX.X
X.X.....X.X...X
X.X.XXX.XXXXX.X
X.X.X.X.....X.X
X...XXX.X.XXX.X
X.....X.X.....X
X.XXX.X.XXX...X
X.X.....X.X.X.X
X.XXXXX.XXX.X.X
X...X.X.....X.X
X.XXXXXXXXXXX.X
X.............X
XXXXXXXXXXXXXXX
