16
XXXXXXXXXXXXXXXXX
X.......X.......X
X..X....X....X..X
X.X.X...X...X.X.X
X..X....X....X..X
X.......X.......X
X.......X.......X
X.......X.......X
XXXXXXXXXXXXXXXXX
X.......X.......X
X.......X.......X
X.......X.......X
X..X....X....X..X
X.X.X...X...X.X.X
X..X....X....X..X
X.......X.......X
XXXXXXXXXXXXXXXXX
