14
XXXXXXXXXXXXXXX
X.....X.X.X.X.X
X.XXX.XXXXXXXXX
X.X...X.X.X.X.X
X.XXX.XXXXXXXXX
X...X.X.X.X.X.X
X.XXX.XXXXXXXXX
X.X...X.X.X.X.X
X.XXX.XXXXXXXXX
X...X.X.X.X.X.X
X.XXX.XXXXXXXXX
X.X...X.X.X.X.X
X.XXX.XXXXXXXXX
X.......X.X.X.X
XXXXXXXXXXXXXXX
