18
XXXXXXXXXXXXXXXXXXX
X.................X
X..X...X...X...X..X
X.X.....X.X.....X.X
X....X.......X....X
X...X.X.....X.X...X
X....X.......X....X
X.X.....X.X.....X.X
X..X...X...X...X..X
X.................X
X..X...X...X...X..X
X.X.....X.X.....X.X
X....X.......X....X
X...X.X.....X.X...X
X....X.......X....X
X.X.....X.X.....X.X
X..X...X...X...X..X
X.................X
XXXXXXXXXXXXXXXXXXX
