10
XXXXXXXXXXX
X.........X
X.XXXXXXX.X
X...X.....X
X.XXX.XXX.X
X.X.....X.X
X.XXX.XXX.X
X.....X...X
X.XXXXXXX.X
X.........X
XXXXXXXXXXX
