20
XXXXXXXXXXXXXXXXXXXXX
X.X...............X.X
XXXXX.XXXXXXXXX.XXXXX
X.X.X.....X.....X.X.X
X.XXXXXXX.X.XXXXXXX.X
X...X.X.X.X.X.X.X...X
X.X.XXXXX.X.XXXXX.X.X
X.X.X.X.X.X.X.X.X.X.X
X.X.XXXXX.X.XXXXX.X.X
X.X...............X.X
X.XXXXXXX.X.XXXXXXX.X
X.X...............X.X
X.X.XXXXX.X.XXXXX.X.X
X.X.X.X.X.X.X.X.X.X.X
X.X.XXXXX.X.XXXXX.X.X
X...X.X.X.X.X.X.X...X
X.XXXXXXX.X.XXXXXXX.X
X.X.X.....X.....X.X.X
XXXXX.XXXXXXXXX.XXXXX
X.X...............X.X
XXXXXXXXXXXXXXXXXXXXX

