14
XXXXXXXXXXXXXXX
X.............X
X.X.X.X.X.X.X.X
X.X.X.X.X.X.X.X
X.X.X.X.X.X.X.X
X.X.X.X.X.X.X.X
X.X.X.X.X.X.X.X
X.X.X.X.X.X.X.X
X.X.X.X.X.X.X.X
X.X.X.X.X.X.X.X
X.X.X.X.X.X.X.X
X.X.X.X.X.X.X.X
X.X.X.X.X.X.X.X
X.............X
XXXXXXXXXXXXXXX
