20
XXXXXXXXXXXXXXXXXXXXX
X...X.X.X.X.X.X.X...X
X..XXXXXXXXXXXXXXX..X
X.X...X.X.X.X.X...X.X
XXX..XXXXXXXXXXX..XXX
X.X.X...X.X.X...X.X.X
XXXXX..XXXXXXX..XXXXX
X.X.X.X.......X.X.X.X
XXXXXXX.......XXXXXXX
X.X.X.X.......X.X.X.X
XXXXXXX.......XXXXXXX
X.X.X.X.......X.X.X.X
XXXXXXX.......XXXXXXX
X.X.X.X.......X.X.X.X
XXXXX..XXXXXXX..XXXXX
X.X.X...X.X.X...X.X.X
XXX..XXXXXXXXXXX..XXX
X.X...X.X.X.X.X...X.X
X..XXXXXXXXXXXXXXX..X
X...X.X.X.X.X.X.X...X
XXXXXXXXXXXXXXXXXXXXX

