16
XXXXXXXXXXXXXXXXX
X...............X
X...X.X.X.X.X.X.X
X...X.X.X.X.X...X
X.XXXXX.X.XXXXX.X
X...X.X.X.X.X...X
X...XXXXXXXXX...X
X.......X.......X
X.....XXXXX.....X
X.......X.......X
X.......X.......X
X.......X.......X
X.XXX...X...XXX.X
X.X.X...X...X.X.X
X.XXX...X...XXX.X
X...............X
XXXXXXXXXXXXXXXXX
