20
XXXXXXXXXXXXXXXXXXXXX
X.X.......X.......X.X
X.XXX.X.XXXX..X.XXX.X
X.....X.......X.....X
XXX.X.XXX...XXX.X.XXX
X...X...........X...X
X.X.XXX.X.XXX.XXX.X.X
X.X.....X...X.....X.X
X.XXX.XXX.X.XXX.XXX.X
X.....X...X.........X
XXXXX.X.XXXXX.X.XXXXX
X.........X...X.....X
X.XXX.XXX.X.XXX.XXX.X
X.X.....X...X.....X.X
X.X.XXX.XXX.X.XXX.X.X
X...X...........X...X
XXX.X.XXX...XXX.X.XXX
X.....X.......X.....X
X.XXX.X..XXX..X.XXX.X
X.X.......X.......X.X
XXXXXXXXXXXXXXXXXXXXX
