14
XXXXXXXXXXXXXXX
X.............X
XXX.X.XXX.X.XXX
X.............X
X.XXX.X.X.XXX.X
X.X.X.X.X.X.X.X
X.XXX.X.X.XXX.X
X.............X
X.XXXXX.XXXXX.X
X.....X.X.....X
XXX.X.XXX.X.XXX
X...X.....X...X
X.X.XXXXXXX.X.X
X.X.........X.X
XXXXXXXXXXXXXXX
