14
XXXXXXXXXXXXXXX
X.............X
X.XXX.XXXXX.X.X
X.X.........X.X
X.X.XXX...XX..X
X.............X
X.XXX.........X
X.X.........X.X
X.X.......XXX.X
X.............X
X.XXX.X.X.XXX.X
X.X...X.X.....X
X.X.X.X.XXX.X.X
X...X.........X
XXXXXXXXXXXXXXX
